actualSize=Actual Size
addProperty=Add
align=Align
apply=Apply
bold=Bold
bottom=Bottom
cancel=Cancel
center=Center
changesLost=All changes will be lost!
clearSelection=Clear Selection
collapse=Collapse
connect=Connect
copy=Copy
currentFile=Current File
cut=Cut
delete=Delete
editStyle=Edit Style
enterColorname=Enter Colorname
enterFontfamily=Enter Fontfamily
enterFontsize=Enter Fontsize (pt)
enterGroup=Enter group
enterImageUrl=Enter Image URL
enterMetadataName=Enter Metadata Name
enterOpacity=Enter Opacity (%)
enterStyle=Enter Style
examples=Examples
exitGroup=Exit group
expand=Expand
exportGraph=Export Workflow as Graph
exportImage=Export Image
exportPROV=Export Workflow as PROV
exportSvg=Export SVG
fillColor=Fill Color
fit=Fit
font=Font
fontColor=Font Color
fontFamily=Font Family
fontSize=Font Size
format=Format
gradientColor=Gradient Color
group=Group
help=Help
horizontalTree=Horizontal Tree
image=Image
importPROV=Import Workflow from PROV
invalidName=Invalid name
italic=Italic
lastSaved=Last Saved
layout=Layout
left=Left
middle=Middle
notAvailable=Not available
opacity=Opacity
open=Load SWW Workflow
openHref=Open URL
pan=Pan
paste=Paste
placeholders=Placeholders
print=Print
properties=Edit Metadata
redo=Redo
removeFromParent=Orphan
right=Right
save=Save
select=Select
selectAll=Select All
selection=Selection
shape=Shape
show=Show
strokeColor=Line Color
swimlanes=Swimlanes
toBack=Send to back
toFront=Bring to front
toggleRounded=Rounded
toggleShadow=Shadow
toolbar=Tools
top=Top
travelBooking=Travel Booking
undo=Undo
ungroup=Ungroup
urlHelp=help/index.html
verticalTree=Vertical Tree
zoom=Zoom
zoomIn=Zoom In
zoomOut=Zoom Out
